%%%%%%%%%%%%%%%%%%%%
%              %*  %
% %% %% %% %% %%%%%%
%                  %
% %%               %
%                  %
%                  %
%                  %
%         P        %
%                  %
%                  %
%%%%%%%%%%%%%%%%%%%%
