%%%%%%%%%%
%        %
%      P %
%  %     %
%  %     %
%  %     %
%  %%%   %
%    %   %
%*       %
%%%%%%%%%%