%%%%%%%%%%%%%%%%%%%%
%              %*  %
% %% %% %% %% %%%%%%
%        P         %
% %%               %
%                  %
%%%%%%%%%%%%%%%%%%%%
