%%%%%%%%%%%%%%%%%%%%
% P                %
%  %               %
%  %               %
%  %%%%%%%%%%%%%% %%
%               % *%
%%%%%%%%%%%%%%%%%%%%