%%%%%%%%%%%%%%%%%%%%%%%%%%%%%%
% *                    %   % %
%  % %                   % P%%
%  %   %                     %
%  %   %                     %
%  %   %                     %
%%%%%%%%%%%%%%%%%%%%%%%%%%%%%%