%%%%%%%%%%%%%%%%%%%%%%%%%%%%%%%%%%%%%%%%%%%%%%%%
%                                              %
%                                              %
%                                  %           %
%                                 %            %
%                             *  %             %
%                               % P            %
%                              %               %
%                                              %
%                                              %
%                                              %
%                                              %
%                                              %
%                                              %
%%%%%%%%%%%%%%%%%%%%%%%%%%%%%%%%%%%%%%%%%%%%%%%%
