%%%%%%%%%%%%%%%%%%%%%%%%%%%%%%%%%%%%%%%%%%%%%%%%
%                                              %
%                                              %
%                                              %
%                                              %
%                                              %
%     P                         *              %
%                                              %
%                                              %
%                                              %
%                                              %
%                                              %
%                                              %
%                                              %
%%%%%%%%%%%%%%%%%%%%%%%%%%%%%%%%%%%%%%%%%%%%%%%%
