%%%%%%%%%%%%%%%
%    %  %     %
%  % P  %     %
%  %  % %     %
%  %%%%%%     %
%      *%     %
%%%%%%%%%%%%%%%
