%%%%%%%%%%%%%%%%%%%%
%              %   %
% %% %% %% %% %%   %
%        P         %
% %%               %
%                * %
%%%%%%%%%%%%%%%%%%%%
