%%%%%%%%%%%%%%%%%%%%
%              %   %
% %% %% %% %% %%%%%%
%        P         %
% %%               %
%                  %
%                  %
%                  %
%                  %
%                  %
%                 *%
%%%%%%%%%%%%%%%%%%%%
