%%%%%%%%%%%%%%%
%    %        %
%  % P  %     %
%  %    %     %
%  %%%%%%     %
%      *%     %
%%%%%%%%%%%%%%%
