%%%%%%%%%%%%%%%%%%%%
% *  %         %   %
% %% %% %% %% %% % %
%        P       % %
%%%%%%%%%%%%%%%%%% %
%                  %
%%%%%%%%%%%%%%%%%%%%