%%%%%%%%%%%%%%%%%%%%
%   %   %   % %  %P%
%       % % % %    %
% % % %    %   %   %
%   %  % %   %   % %
% *%%%      %% %   %
%%%%%%%%%%%%%%%%%%%%