%%%%%%%%%%%%%%%%%%%%%%%%%%%%%%%%%%%%%%%%%%%%%%%%
%              %        %        %        %    %
%              %        %        %        %    %
%        %%%%     %%%%     %%%%     %%%%       %
%   P       %        %        %        %     * %
%        %%%%     %%%%     %%%%     %%%%       %
%              %        %        %        %    %
%              %        %        %        %    %
%              %        %        %        %    %
%%%%%%%%%%%%%%%%%%%%%%%%%%%%%%%%%%%%%%%%%%%%%%%%
