%%%%%%%%%%%%%%%%%%%%
%                  %
% %% %% %% %% %% % %
%        P       % %
%%%%%%%%%%% %%%%%% %
%       %     % *  %
%%%%% %%%% %%%%%% %%
%                  %
%%%%%%%%%%%%%%%%%%%%