%%%%%%%%%%%%%%%%%%%%%%%%%%%%%%%%%%%%%%%%%%%%%%%%
%          %        %        %        %        %
%   P      %        %        %        %        %
%          %        %                 %        %
%          %       * %       %        %        %
%       %%%%     %%%%        %%%%     %%%%     %
%       %        %               %        %    %
%       %        %               %        %    %
%       %        %               %        %    %
%       %%%%     %%%%        %%%%     %%%%     %
%          %                 %        %        %
%          %        %        %        %        %
%          %        %        %        %        %
%          %        %        %                 %
%          %        %        %        %        %
%                   %        %        %        %
%%%%%%%%%%%%%%%%%%%%%%%%%%%%%%%%%%%%%%%%%%%%%%%%
