%%%%%%%%%%%%%%%%%%%%%%%%%%%%%%%%%%%%%%%%%%%%%%%%
%              %        %        %        %    %
%              %        %        %        %    %
%        %%%%     %%%%     %%%%     %%%%       %
%           %        %        %        %       %
%   P       %        %        %        %     * %
%           %        %        %        %       %
%        %%%%     %%%%     %%%%     %%%%       %
%              %        %        %        %    %
%              %        %        %        %    %
%              %        %        %        %    %
%%%%%%%%%%%%%%%%%%%%%%%%%%%%%%%%%%%%%%%%%%%%%%%%
