%%%%%%%%%%%%%%%%%%%%
% *            %   %
% %% %% %% %% %% % %
%        P       % %
% %%             % %
%                  %
%%%%%%%%%%%%%%%%%%%%
